....................................................
....................................................
....................................................
....................................................
....................................................
.LVPPPPPPPPPPPPPPPPPPPPPPPPPPPPPPPPPPPP.............
......................................P.............
.PPPPPPPPPPPPPPPPPPPPPPPPPPPPPPPPPPPPPP.............
....................................................
....................................................
....................................................
....................................................
.......FFF..........................................