....................................................
....................................................
....................................................
....................................................
....................................................
.LPPPPPPVPPPPPPPPPPPPPPPPPPPVPPPPPPPPPP.............
......................................P.............
.PPPPPPPPPPPPPPPPPPPPPPPPPPPPPPPPPPPPPP.............
....................................................
....................................................
....................................................
....................................................
.......FFF..........................................